######################################      ##########################################
#                                                                                    #
#                                                                                    #
#                                                                                    #
#                                                          #                         #
#              ##################################          #                         #
#                          #                               #                         #
                           #                               #                         #
                                                           #                         #
                                                           #                         #
#                          #                               #                         #
#                          #                               #                         #
#               ############                  #############################          #
#                                                                                    #
#                                                                                    #
#                                                                                    #
######################################      ##########################################