######################################......##########################################
#....................................................................................#
#....................................................................................#
#....................................................................................#
#..........................................................#.........................#
#..............##################################..........#.........................#
#..........................#...............................#.........................#
...........................#...............................#.........................#
...........................................................#.........................#
...........................................................#.........................#
#..........................#...............................#.........................#
#..........................#...............................#.........................#
#...............############..................#############################..........#
#....................................................................................#
#....................................................................................#
#....................................................................................#
######################################......##########################################