######################################......########################
#..................................................................#
#..................................................................#
#..................................................................#
#..........................................................#.......#
#..............##################################..........#.......#
#..........................#...............................#.......#
...........................#...............................#.......#
...........................................................#.......#
...........................................................#.......#
#..........................#...............................#.......#
#..........................#...............................#.......#
#...............############..................######################
#..................................................................#
#..................................................................#
#..................................................................#
#..................................................................#
#..................................................................#
######################################......########################
